00000000000000000000
00000000000000000000
00001111100000111110
00000000000000000000
00000000000000400000
00001110000111110000
00000000000000000000
11000000000000000000
00001000000000000000
000000000000000Z0000
00000011100011110000
11111111111111111111
