00000000000000000000
00000000000000000000
00000001110000000000
11111000000000000000
00000000000000000000
00000000011110000000
00000000000000000000
00000000000000000000
00000000000000111111
00000000011100000000
00001110000000000000
11111111111111111111