00000000000000000000
00000000000000000000
00010001110000000000
00000000000000000000
00000000000000000000
00000000000000000000
00000000000000000000
00000000000000000000
00000000000000111000
00000000011100000000
00001110000000000000
11111111111111111111